{
    "objects":[
        {
            "type":"block",
            "texture":0
        },
        {
            "type":"block",
            "texture":1
        },
        {
            "type":"block",
            "texture":2
        },
        {
            "type":"block",
            "texture":3
        },
        {
            "type":"block",
            "texture":4
        },
        {
            "type":"block",
            "texture":5
        },
        {
            "type":"block",
            "texture":6
        },
        {
            "type":"door",
            "texture":7
        },
        {
            "type":"sprite",
            "texture":0
        },
        {
            "type":"sprite",
            "texture":1
        }
    ],
    "tiles": [
        [7,7,7,7,7,7,7,7,7,7,7,7,7,7,7,7,7,7,7,7,7,7,7,2,2,2,2],
        [4,0,0,0,0,0,0,0,0,0,0,0,0,0,0,3,0,0,0,8,0,0,0,2,0,0,2],
        [4,0,0,0,0,0,0,2,2,2,2,2,2,0,0,3,0,3,3,3,0,0,0,8,0,0,2],
        [4,0,3,3,0,0,0,2,0,0,0,0,2,0,0,0,0,0,0,3,0,0,0,2,0,0,2],
        [4,0,3,3,0,0,2,2,0,2,2,0,2,0,0,3,3,3,0,3,0,0,0,2,0,0,2],
        [4,0,3,3,0,0,2,0,0,0,2,0,2,0,0,3,0,0,0,3,0,0,0,2,2,8,2],
        [4,0,3,3,0,0,2,0,0,0,0,0,2,0,0,3,0,3,3,3,0,0,0,2,0,0,2],
        [4,0,0,0,0,0,2,0,0,0,2,2,2,0,0,0,0,0,0,0,0,0,0,2,0,0,2],
        [4,0,0,0,0,0,2,2,0,2,2,10,0,0,0,3,9,3,9,3,0,0,0,2,0,0,2],
        [4,0,0,0,0,0,0,0,0,0,0,0,0,0,0,0,0,0,0,0,0,0,0,2,0,0,2],
        [4,0,0,0,0,0,0,0,0,0,0,0,0,0,0,0,0,0,0,0,0,0,0,2,0,0,2],
        [4,0,6,6,0,6,0,0,0,0,0,5,5,5,5,5,0,0,0,0,0,0,0,2,0,9,2],
        [4,0,6,10,0,6,0,0,0,0,0,8,0,0,0,5,0,0,0,0,0,0,0,2,0,0,2],
        [4,0,0,0,0,6,0,0,0,0,0,5,0,9,0,5,0,0,0,0,0,0,0,2,0,9,2],
        [4,0,6,6,6,6,0,0,0,0,0,5,0,0,0,5,0,0,0,0,0,0,0,2,0,0,2],
        [4,0,0,0,0,0,0,0,0,0,0,5,5,5,5,5,0,0,1,10,0,1,1,2,0,9,2],
        [4,4,4,4,4,4,4,4,4,0,0,0,0,8,0,0,0,0,1,0,0,0,0,2,0,0,2],
        [4,4,0,4,0,0,0,0,4,0,0,0,0,4,0,0,0,0,1,0,0,1,1,2,0,2,2],
        [4,4,0,0,0,0,7,0,4,4,0,4,4,4,0,0,0,0,1,0,0,0,0,2,0,0,2],
        [4,4,0,4,0,0,0,0,4,0,0,0,0,0,0,0,0,0,1,0,0,1,1,2,2,0,2],
        [4,4,0,4,4,4,4,4,4,0,0,0,0,0,0,0,0,0,1,0,0,0,0,2,0,0,2],
        [4,4,0,0,0,0,0,0,8,0,0,4,4,4,0,0,0,0,1,0,0,0,0,8,0,0,2],
        [4,4,4,4,4,4,4,4,4,0,0,0,0,0,0,0,0,0,1,10,0,0,0,2,0,0,2],
        [4,1,1,1,1,1,1,1,1,1,1,1,1,1,1,1,1,1,1,1,1,1,1,1,2,2,2]
    ],
    "textures":"textures.png",
    "sprites":"sprites.png"
}
