[
    [7,7,7,7,7,7,7,7,7,7,7,7,7,7,7,7,7,7,7,7,7,7,7,2,2,2,2],
    [4,0,0,0,0,0,0,0,0,0,0,0,0,0,0,3,0,0,0,40,0,0,0,2,0,0,2],
    [4,0,0,0,0,0,0,2,2,2,2,2,2,0,0,3,0,3,3,3,0,0,0,40,0,0,2],
    [4,0,3,3,0,0,0,2,0,0,0,0,2,0,0,0,0,0,0,3,0,0,0,2,0,0,2],
    [4,0,3,3,0,0,2,2,0,2,2,0,2,0,0,3,3,3,0,3,0,0,0,2,0,0,2],
    [4,0,3,3,0,0,2,0,0,0,2,0,2,0,0,3,0,0,0,3,0,0,0,2,2,40,2],
    [4,0,3,3,0,0,2,0,0,0,0,0,2,0,0,3,0,3,3,3,0,0,0,2,0,0,2],
    [4,0,0,0,0,0,2,0,0,0,2,2,2,0,0,0,0,0,0,0,0,0,0,2,0,0,2],
    [4,0,0,0,0,0,2,2,0,2,2,18,0,0,0,3,17,3,17,3,0,0,0,2,0,0,2],
    [4,0,0,0,0,0,0,0,0,0,0,0,0,0,0,0,0,0,0,0,0,0,0,2,0,0,2],
    [4,0,0,0,0,0,0,0,0,0,0,0,0,0,0,0,0,0,0,0,0,0,0,2,0,0,2],
    [4,0,6,6,0,6,0,0,0,0,0,5,5,5,5,5,0,0,0,0,0,0,0,2,0,17,2],
    [4,0,6,18,0,6,0,0,0,0,0,40,0,0,0,5,0,0,0,0,0,0,0,2,0,0,2],
    [4,0,0,0,0,6,0,0,0,0,0,5,0,17,0,5,0,0,0,0,0,0,0,2,0,17,2],
    [4,0,6,6,6,6,0,0,0,0,0,5,0,0,0,5,0,0,0,0,0,0,0,2,0,0,2],
    [4,0,0,0,0,0,0,0,0,0,0,5,5,5,5,5,0,0,1,18,0,1,1,2,0,17,2],
    [4,4,4,4,4,4,4,4,4,0,0,0,0,40,0,0,0,0,1,0,0,0,0,2,0,0,2],
    [4,4,0,4,0,0,0,0,4,0,0,0,0,4,0,0,0,0,1,0,0,1,1,2,0,2,2],
    [4,4,0,0,0,0,7,0,4,4,0,4,4,4,0,0,0,0,1,0,0,0,0,2,0,0,2],
    [4,4,0,4,0,0,0,0,4,0,0,0,0,0,0,0,0,0,1,0,0,1,1,2,2,0,2],
    [4,4,0,4,4,4,4,4,4,0,0,0,0,0,0,0,0,0,1,0,0,0,0,2,0,0,2],
    [4,4,0,0,0,0,0,0,40,0,0,4,4,4,0,0,0,0,1,0,0,0,0,40,0,0,2],
    [4,4,4,4,4,4,4,4,4,0,0,0,0,0,0,0,0,0,1,18,0,0,0,2,0,0,2],
    [4,1,1,1,1,1,1,1,1,1,1,1,1,1,1,1,1,1,1,1,1,1,1,1,2,2,2]
]